تقصیر و تقاعدی که در مواظبت خدمت بارگاه خداوندی می‌رود بنا بر آن است که طایفه‌ای از حکماء هندوستان در فضایل بزرجمهر سخن می‌گفتند، به آخر جز این عیبش ندانستند که در سخن گفتن بطیء است یعنی درنگ بسیار می‌کند و مستمع را بسی منتظر باید بودن تا تقریر سخنی کند. بزرجمهر بشنید و گفت: اندیشه کردن که چه گویم به از پشیمانی خوردن که چرا گفتم.
بر سلامت حالش شادمانی کرد و از هر دری سخن گفتند تا ملک به انجام سخن گفت: چنین که من این هر دو طایفه را دوست دارم در جهان کس ندارد یکی علما و دیگر زهاد را.
اما صاحب دنیا به عین عنایت حق ملحوظ است و به حلال از حرام محفوظ. من همانا که تقریر این سخن نکردم و برهان بیان نیاوردم، انصاف از تو توقع دارم هرگز دیده‌ای دست دعایی بر کتف بسته یا بینوایی به زندان در نشسته یا پردهٔ معصومی دریده یا کفی از معصم بریده، الا به علت درویشی؟ شیرمردان را به حکم ضرورت در نقبها گرفته‌اند و کعبها سفته و محتمل است آن که یکی را از درویشان نفس اماره طلب کند، چو قوت احصانش نباشد، به عصیان مبتلا گردد که بطن و فرج توأمند، یعنی فرزند یک شکمند: مادام که این یکی برجای است، آن دگر بر پای است. شنیدم که درویشی را با حدثی بر خبثی گرفتند. با آن که شرمساری برد، بیم سنگساری بود. گفت: ای مسلمانان قوت ندارم که زن کنم و طاقت نه که صبر کنم چه کنم؟ لا رهبانیة فی الاسلام. وز جمله مواجب سکون و جمعیت درون که مر توانگر را میسر می‌شود یکی آن که هر شب صنمی در بر گیرد که هر روز بدو جوانی از سر گیرد صبح تابان را دست از صباحت او بر دل و سرو خرامان را پای از خجالت او در گل.
به نام خداوندِ جان‌آفرین		حکیمِ سخن‌درزبان‌آفرین
مگر بویی از عشق مستت کند		طلبکار عهد الستت کند
ندانم کدامین سخن گویمت		که والاتری زانچه من گویمت
مرا گر تهی بود از آن قند دست		سخنهای شیرین‌تر از قند هست
سوم باب عشق است و مستی و شور		نه عشقی که بندند بر خود بزور
تو نیز ار بدی بینیم در سخن		به خلق جهان آفرین کار کن
خرابی و بدنامی آید ز جور		رسد پیش بین این سخن را به غور

بمانده‌ست با دامنی گوهرم		هنوز از خجالت به زانو برم
شنیدم که در روز امید و بیم		بدان را به نیکان ببخشد کریم
طلبکار خیر است امیدوار		خدایا امیدی که دارد برآر
برومند دارش درخت امید		سرش سبز و رویش به رحمت سفید
اگر جاده‌ای بایدت مستقیم		ره پارسایان امید است و بیم
طبیعت شود مرد را بخردی		به امید نیکی و بیم بدی
که بخشایش آرد بر امیدوار		به امید بخشایش کردگار
سخن گفت و دامان گوهر فشاند		به نطقی که شه آستین برفشاند
زرش داد و گوهر به شکر قدوم		بپرسیدش از گوهر و زاد و بوم
تو هم بر دری هستی امیدوار		پس امید بر در نشینان برآر

اتابک محمد شه نیکبخت		خداوند تاج و خداوند تخت
بزرگان روشندل نیکبخت		به فرزانگی تاج بردند و تخت
یکی را به سر برنهد تاج بخت		یکی را به خاک اندر آرد ز تخت
نه از بهر آن می‌ستانم خراج		که زینت کنم بر خود و تخت و تاج
مخالف خرش برد و سلطان خراج		چه اقبال ماند در آن تخت و تاج؟
دگر خواست کافزون کند تخت و تاج		بیافزود بر مرد دهقان خراج
اگر ملک بر جم بماندی و بخت		تو را کی میسر شدی تاج و تخت؟
کرم پای دارد، نه دیهیم و تخت		بده کز تو این ماند ای نیکبخت
ذکر جمیل سعدی که در افواه عوام افتاده است و صیت سخنش که در بسیط زمین رفته و قصب الجیب حدیثش که همچون شکر می‌خورند و رقعهٔ منشآتش که چون کاغذ زر می‌برند بر کمال فضل و بلاغت او حمل نتوان کرد بلکه خداوند جهان و قطب دایرهٔ زمان و قایم مقام سلیمان و ناصر اهل ایمان اتابک اعظم مظفر الدنیا و الدین ابوبکر بن سعد بن زنگی ظلّ الله تعالی فی ارضه رَبِّ اِرْضَ عَنهُ و اَرْضِه به عین عنایت نظر کرده است و تحسین بلیغ فرموده و ارادت صادق نموده، لاجرم کافهٔ انام از خواص و عوام به محبت او گراییده‌اند که الناسُ علی دینِ ملوکِهم.
خداوندان کام و نیکبختی		چرا سختی خورند از بیم سختی

مرا لفظ شیرین خواننده داد		تو را سمع و ادراک داننده داد
نه ادراک در کنه ذاتش رسید		نه فکرت به غور صفاتش رسید
به سمع رضا مشنو ایذای کس		وگر گفته آید به غورش برس
در ارکان دولت نگه کرد شاه		کز این خوبتر لفظ و معنی مخواه
بد اندیش را لفظ شیرین مبین		که ممکن بود زهر در انگبین
چو بسم الله آغاز کردند جمع		نیامد ز پیرش حدیثی به سمع
همی گفت و گریان بر احوال طی		به سمع رسول آمد آواز وی
چنین دارم از پیر داننده یاد		که شوریده‌ای سر به صحرا نهاد
زبان کرد شخصی به غیبت دراز		بدو گفت داننده‌ای سرفراز
در این شهر باری به سمعم رسید		که بازارگانی غلامی خرید

عسل دادت از نحل و من از هوا		رطب دادت از نخل و نخل از نوی
تن کارکن می‌بلرزد ز تب		مبادا که نخلش نیارد رطب
ز روشن دلش ملک پرتو گرفت		وزیر کهن را غم نو گرفت
رطب ناورد چوب خرزهره بار		چو تخم افکنی، بر همان چشم دار
الا تا به غفلت نخفتی که نوم		حرام است بر چشم سالار قوم
هوا بینی از گرد هیجا چو میغ		بگیرند گردت به زوبین و تیغ
نو آموز را ریسمان کن دراز		نه بگسل که دیگر نبینیش باز
نه دینار دادش سیه دل نه دانگ		بر او زد به سر باری از طیره بانگ
سماطی بیفکند و اسبی بکشت		به دامن شکر دادشان زر به مشت
غم جمله خور در هوای یکی		مراعات صد کن برای یکی

سر آنگه به بالین نهد هوشمند		که خوابش به قهر آورد در کمند
تواضع کند هوشمند گزین		نهد شاخ پر میوه سر بر زمین
فروتن بود هوشمند گزین		نهد شاخ پر میوه سر بر زمین
شنیدم که سحرگاهی با تنی چند خاصان به بالین قاضی فراز آمد. شمع را دید ایستاده و شاهد نشسته و می ریخته و قدح شکسته و قاضی در خواب مستی بی خبر از ملک هستی.
چه سود از دزدی آنگه توبه کردن		که نتوانی کمند انداخت بر کاخ
اگر بر جفاپیشه بشتافتی		که از دست قهرش امان یافتی؟
نهد لعل و پیروزه در صلب سنگ		گل و لعل در شاخ پیروزه‌رنگ
به دانش بزرگ و به همت بلند		به بازو دلیر و به دل هوشمند
دگر کشور آباد بیند به خواب		که دارد دل اهل کشور خراب
کی آن جا دگر هوشمندان روند		چو آوازهٔ رسم بد بشنوند؟

هر آن سری که در سر داری با دوست در میان منه چه دانی که وقتی دشمن گردد و هر گزندی که توانی، به دشمن مرسان که باشد که وقتی دوست شود.
ادیم زمین، سفرهٔ عام اوست		بر این خوان یغما چه دشمن چه دوست
غم از دشمن ناپسندش مباد		وز اندیشه بر دل گزندش مباد
محال است چون دوست دارد تو را		که در دست دشمن گذارد تو را
ز بیگانه پرهیز کردن نکوست		که دشمن توان بود در زی دوست
کنون تا یقینت نگردد گناه		به گفتار دشمن گزندش مخواه
نه تدبیر محمود و رای نکوست		که دشمن نداند شهنشه ز دوست
مرا با تو دانی سر دوستی است		تو را دشمنی با من از بهر چیست؟
چرا دوست دارم به باطل منت		چو دانم که دارد خدا دشمنت؟
خدادوست را گر بدرند پوست		نخواهد شدن دشمن دوست، دوست

هارون الرشید را چون ملک دیار مصر مسلم شد گفت: به خلاف آن طاغی که به غرور ملک مصر دعوی خدایی کرد نبخشم این مملکت را مگر به خسیس‌ترین بندگان.
اسکندر رومی را پرسیدند: دیار مشرق و مغرب به چه گرفتی که ملوک پیشین را خزاین و عمر و ملک و لشکر بیش از این بوده است ایشان را چنین فتحی میسر نشده. گفتا: به عون خدای عزّوجل هر مملکتی را که گرفتم رعیتش نیازردم و نام پادشاهان جز به نکویی نبردم.
دهقان پسری یافتند بر آن صورت که حکیمان گفته بودند، پدرش را و مادرش را بخواند و به نعمت بیکران خشنود گردانیدند و قاضی فتوی داد که خون یکی از رعیت ریختن سلامت پادشه را روا باشد. جلاد قصد کرد، پسر سر سوی آسمان بر آورد و تبسم کرد. ملک پرسیدش که در این حالت چه جای خندیدن است؟ گفت: ناز فرزندان بر پدران و مادران باشد و دعوی پیش قاضی برند و داد از پادشه خواهند. اکنون پدر و مادر به علّت حطام دنیا مرا به خون در سپردند و قاضی به کشتن فتوی داد و سلطان مصالح خویش اندر هلاک من همی‌بیند، به جز خدای عزّوجل پناهی نمی‌بینم.
ز جرمم در این مملکت جاه نیست		ولیکن به ملکی دگر راه نیست
دیگر عروس فکر من از بی جمالی سر بر نیارد و دیدهٔ یأس از پشت پای خجالت بر ندارد و در زمرهٔ صاحبدلان متجلی نشود مگر آن گه که متحلّی گردد به زیور قبول امیر کبیر عالم عادل مؤید مظفر منصور ظهیر سریر سلطنت و مشیر تدبیر مملکت کهف الفقرا ملاذُ الغربا مربّی الفضلا محبُّ الاتقیا افتخار آل فارس یمینُ الملک ملک الخواص فخر الدولة والدین غیاث الاسلام و المسلمین عمدةُ الملوکِ و السلاطین ابوبکر بنُ ابی نصر اطال الله عمرَه و اجل قدرَه و شرَح صدرَه و ضاعَف اجرَه که ممدوح اکابر آفاق است و مجموع مکارم اخلاق.
این بگفت و طایفه ای از ندمای ملک با وی به شفاعت یار شدند تا ملک از سر خون او در گذشت و گفت: بخشیدم اگر چه مصلحت ندیدم.
باری به مجلس او در کتاب شاهنامه همی‌خواندند در زوال مملکت ضحّاک و عهد فریدون وزیر ملک را پرسید هیچ توان دانستن که فریدون که گنج و ملک و حشم نداشت چگونه برو مملکت مقرر شد گفت آن چنان که شنیدی خلقی برو به تعصب گرد آمدند و تقویت کردند و پادشاهی یافت گفت ای ملک چو گرد آمدن خلقی موجب پادشاهیست تو مر خلق را پریشان برای چه می‌کنی مگر سر پادشاهی کردن نداری
یکی از ملوک عرب رنجور بود در حالت پیری و امید زندگانی قطع کرده که سواری از در درآمد و بشارت داد که فلان قلعه را به دولت خداوند گشادیم و دشمنان اسیر آمدند و سپاه و رعیت آن طرف بجملگی مطیع فرمان گشتند ملک نفسی سرد بر آورد و گفت این مژده مرا نیست دشمنانم راست یعنی وارثان مملکت.
در حالتی که ملک را پروای او نبود حال بگفتند به هم بر آمد و روی از او در هم کشید و از اینجا گفته‌اند اصحاب فطنت و خبرت که از حِدّت و سَورت پادشاهان بر حذر باید بودن که غالب همت ایشان به معظمات امور مملکت متعلق باشد و تحمل ازدحام عوام نکند.
ملک گفتا هر آینه ما را خردمندی کافی باید که تدبیر مملکت را بشاید گفت ای ملک نشان خردمند کافی جز آن نیست که به چنین کارها تن ندهد.

روزگاری برآمد که اتفاق ملاقات نیوفتاد. بعد از آن دیدمش زن خواسته و فرزندان خاسته و بیخ نشاطش بریده و گل هوس پژمریده.
اما صاحب دنیا به عین عنایت حق ملحوظ است و به حلال از حرام محفوظ. من همانا که تقریر این سخن نکردم و برهان بیان نیاوردم، انصاف از تو توقع دارم هرگز دیده‌ای دست دعایی بر کتف بسته یا بینوایی به زندان در نشسته یا پردهٔ معصومی دریده یا کفی از معصم بریده، الا به علت درویشی؟ شیرمردان را به حکم ضرورت در نقبها گرفته‌اند و کعبها سفته و محتمل است آن که یکی را از درویشان نفس اماره طلب کند، چو قوت احصانش نباشد، به عصیان مبتلا گردد که بطن و فرج توأمند، یعنی فرزند یک شکمند: مادام که این یکی برجای است، آن دگر بر پای است. شنیدم که درویشی را با حدثی بر خبثی گرفتند. با آن که شرمساری برد، بیم سنگساری بود. گفت: ای مسلمانان قوت ندارم که زن کنم و طاقت نه که صبر کنم چه کنم؟ لا رهبانیة فی الاسلام. وز جمله مواجب سکون و جمعیت درون که مر توانگر را میسر می‌شود یکی آن که هر شب صنمی در بر گیرد که هر روز بدو جوانی از سر گیرد صبح تابان را دست از صباحت او بر دل و سرو خرامان را پای از خجالت او در گل.
مگر روزگاری هوس راندمی		ز خود گرد محنت بیفشاندمی
تو با خود ببر توشه خویشتن		که شفقت نیاید ز فرزند و زن
نشاید هوس باختن با گلی		که هر بامدادش بود بلبلی
زن خوب خوش خوی آراسته		چه ماند به نادان نو خاسته؟
وگر زن کند گوید از دست دل		به گردن در افتاد چون خر به گل
دریغا که بی ما بسی روزگار		بروید گل و بشکفد نوبهار
بامدادان که خاطر باز آمدن بر رای نشستن غالب آمد دیدمش دامنی گل و ریحان و سنبل و ضیمران فراهم آورده و رغبت شهر کرده. گفتم: گل بستان را چنان که دانی بقایی و عهد گلستان را وفایی نباشد و حکما گفته‌اند هر چه نپاید دلبستگی را نشاید. گفتا: طریق چیست؟ گفتم: برای نزهت ناظران و فسحت حاضران کتاب گلستان توانم تصنیف کردن که باد خزان را بر ورق او دست تطاول نباشد و گردش زمان عیش ربیعش را به طیش خریف مبدل نکند.
حالی که من این بگفتم دامن گل بریخت و در دامنم آویخت که الکریم اذا وعدَ وفا. فصلی در همان روز اتفاق بیاض افتاد در حسن معاشرت و آداب محاورت در لباسی که متکلمان را به کار آید و مترسّلان را بلاغت بیفزاید. فی الجمله هنوز از گل بستان بقیّتی موجود بود که کتاب گلستان تمام شد.

فرشته خوی شود آدمی به کم خوردن		وگر خورد چو بهایم بیوفتد چو جماد
ز فرخنده خویی نخوردی بگاه		مگر بینوایی در آید ز راه
به کم کردن از عادت خویش خورد		توان خویشتن را ملک خوی کرد
نخست آدمی سیرتی پیشه کن		پس آن گه ملک خویی اندیشه کن
نه مسواک در روزه گفتی خطاست		بنی آدم مرده خوردن رواست؟
من آدمی به چنین شکل و خوی و قد و روش		ندیده‌ام مگر این شیوه از پری آموخت
بفرمودش تا حاضر آوردند و ملامت کردن گرفت که: در شرف نفس انسان چه خلل دیدی که خوی بهایم گرفتی و ترک عشرت مردم گفتی؟
از دست تو مشت بر دهان خوردن		خوشتر که به دست خویش نان خوردن
ده آدمی بر سفره‌ای بخورند و دو سگ بر مرداری با هم به سر نبرند. حریص با جهانی گرسنه است و قانع به نانی سیر. حکما گفته‌اند: توانگری به قناعت، به از توانگری به بضاعت.
فرشته‌ای که وکیل است بر خزاین باد		چه غم خورد که بمیرد چراغ پیرزنی

