زورمندی مکن بر اهل زمین		تا دعایی بر آسمان نرود
یکی زندگانی تلف کرده بود		به جهل و ضلالت سر آورده بود
سگالند از او نیکمردان حذر		که خشم خدای است بیدادگر
در اندیشه‌ام تا کدامم کریم		از آن سنگدل دست گیرد به سیم
قدیمی نکوکار نیکی‌پسند		به کلک قضا در رحم نقش‌بند
یکی زآن میان به فراست به جای آورد و گفت: ای ملک! ما در این دنیا به جیش از تو کمتریم و به عیش خوشتر و به مرگ برابر و به قیامت بهتر.
چو چنگش کشیدند حالی به موی		غلامان و چون دف زدندش به روی
چو زاو کرده باشم تحمل بسی		توانم جفا بردن از هر کسی
که این را ندانم چه خوانند و کیست!		نخواهد به سامان در این ملک زیست
که تا هست حاتم در ایام من		نخواهد به نیکی شدن نام من

بگفت احوال ما برق جهان است		دمی پیدا و دیگر دم نهان است
ولیکن خداوند بالا و پست		به عصیان در رزق بر کس نبست
خداوندگارا نظر کن به جود		که جرم آمد از بندگان در وجود
سعید آورد قول سعدی به جای		که ترتیب ملک است و تدبیر رای
اگر نفع کس در نهاد تو نیست		چنین گوهر و سنگ خارا یکی است
پی نیک‌مردان بباید شتافت		که هر کاین سعادت طلب کرد یافت
همه وقت مردم ز جور زمان		بنالند و از گردش آسمان
گروهی عمل دار عزلت نشین		قدمهای خاکی، دم آتشین
بسی دیده شاهان و دوران و امر		سرآورده عمری ز تاریخ عمرو
مریز آبروی برادر به کوی		که دهرت نریزد به شهر آبروی

اتابک محمد شه نیکبخت		خداوند تاج و خداوند تخت
آورده‌اند که انوشیروان عادل را در شکارگاهی صید کباب کردند و نمک نبود غلامی به روستا رفت تا نمک آرد نوشیروان گفت نمک به قیمت بستان تا رسمی نشود و ده خراب نگردد گفتند از این قدر چه خلل آید گفت بنیاد ظلم در جهان اوّل اندکی بوده است هر که آمد بر او مزیدی کرده تا بدین غایت رسیده
بفرمودش تا حاضر آوردند و ملامت کردن گرفت که: در شرف نفس انسان چه خلل دیدی که خوی بهایم گرفتی و ترک عشرت مردم گفتی؟
کرا پای خاطر بر آمد به سنگ		نیندیشد از شیشهٔ نام و ننگ
گر از فتنه آید کسی در پناه		ندارد جز این کشور آرامگاه
چه جرم دید خداوند سابق الانعام 		که بنده در نظر خویش خوار می‌دارد
بازرگانی را شنیدم که صد و پنجاه شتر بار داشت و چهل بنده خدمتکار.
تو را نیست این تکیه بر کردگار		که مملوک را بر خداوندگار
به منزلگه حاتم آمد فرود		بر آسود چون تشنه بر زنده رود
ز کار بسته میندیش و دل شکسته مدار 		که آب چشمه حیوان درون تاریکی است

مرا لفظ شیرین خواننده داد		تو را سمع و ادراک داننده داد
ذکر جمیل سعدی که در افواه عوام افتاده است و صیت سخنش که در بسیط زمین رفته و قصب الجیب حدیثش که همچون شکر می‌خورند و رقعهٔ منشآتش که چون کاغذ زر می‌برند بر کمال فضل و بلاغت او حمل نتوان کرد بلکه خداوند جهان و قطب دایرهٔ زمان و قایم مقام سلیمان و ناصر اهل ایمان اتابک اعظم مظفر الدنیا و الدین ابوبکر بن سعد بن زنگی ظلّ الله تعالی فی ارضه رَبِّ اِرْضَ عَنهُ و اَرْضِه به عین عنایت نظر کرده است و تحسین بلیغ فرموده و ارادت صادق نموده، لاجرم کافهٔ انام از خواص و عوام به محبت او گراییده‌اند که الناسُ علی دینِ ملوکِهم.
عجب گر بود راهم از دست راست		که از دست من جز کجی برنخاست
قوی در بلاغات و در نحو چست		ولی حرف ابجد نگفتی درست
دگر روز خادم گرفتش به راه		که ناخوب کردی به رأی تباه
مقدمه نحو زمخشری در دست داشت و همی خواند: ضرب زیدُ عمرواً و کان المتعدیّ عمرواً. گفتم: ای پسر، خوارزم و ختا صلح کردند و زید و عمرو را همچنان خصومت باقیست؟ بخندید و مولدم پرسید، گفتم: خاک شیراز. گفت: از سخنان سعدی چه داری؟ گفتم:
فطوبی لباب کبیت العتیق		حوالیه من کل فج عمیق
در معانی این آیت که «و نَحن اَقرَبُ الیه مِنْ حَبل الورید» سخن به جایی رسانیده که گفتم:
با بدان یار گشت همسر لوط 		خاندان نبوّتش گم شد
تو را عز لولاک تمکین بس است		ثنای تو طه و یس بس است

عسل دادت از نحل و من از هوا		رطب دادت از نخل و نخل از نوی
یکی یهود و مسلمان نزاع می‌کردند		چنان که خنده گرفت از حدیث ایشانم
مترس از جوانان شمشیر زن		حذر کن ز پیران بسیار فن
مشورت با زنان تباه است و سخاوت با مفسدان گناه.
به صید هژبران پرخاش ساز		کمند اژدهای دهن کرده باز
کنون کوش کآب از کمر در گذشت		نه وقتی که سیلابت از سر گذشت
که نارفته بیرون ز آغوش زن		کدامش هنر باشد و رای و فن؟
پس از مدتی که باز آمد عتاب آغاز کرد که: در این مدت قاصدی نفرستادی.
دمی نرگس از خواب نوشین بشوی		چو گلبن بخند و چو بلبل بگوی
باز از شماتت اعدا بر اندیشم که به طعنه در قفای من بخندند و سعی مرا در حق عیال بر عدم مروّت حمل کنند و گویند

سر آنگه به بالین نهد هوشمند		که خوابش به قهر آورد در کمند
تواضع کند هوشمند گزین		نهد شاخ پر میوه سر بر زمین
اگر بمرد عدو جای شادمانی نیست		که زندگانی ما نیز جاودانی نیست
دانی که چه گفت زال با رستم گرد 		دشمن نتوان حقیر و بیچاره شمرد
یکی رفت و دینار از او صد هزار		خلف برد صاحبدلی هوشیار
مرا شرمساری ز روی تو بس		دگر شرمسارم مکن پیش کس
چشم بداندیش که برکنده باد		عیب نماید هنرش در نظر
که من بعد بی آبرویی مکن		ادب نیست پیش بزرگان سخن
جفای پدر برد و زندان و بند		چنان سودمندش نیامد که پند
ز بخت روی ترش کرده پیش یار عزیز		مرو که عیش بر او نیز تلخ گردانی

هر آن سری که در سر داری با دوست در میان منه چه دانی که وقتی دشمن گردد و هر گزندی که توانی، به دشمن مرسان که باشد که وقتی دوست شود.
اگر کنج خلوت گزیند کسی		که پروای صحبت ندارد بسی
چو پرخاش بینی تحمل بیار		که سهلی ببندد در کارزار
از این به نصیحت نگوید کست		اگر عاقلی یک اشارت بست
بدو گفتم ای یار آشفته هوش		شگفت آمد این داستانم به گوش
به محشر گواه گناهم گر اوست		ز دوزخ نترسم که کارم نکوست
گر از هستی حق خبر داشتی		همه خلق را نیست پنداشتی
خداوند تدبیر و فرهنگ و هوش		نگوید سخن تا نبیند خموش
در این کشور آسایش و خرمی		ندید و نبیند به چشم آدمی
ره نیکمردان آزاده گیر		چو استاده‌ای دست افتاده گیر

هارون الرشید را چون ملک دیار مصر مسلم شد گفت: به خلاف آن طاغی که به غرور ملک مصر دعوی خدایی کرد نبخشم این مملکت را مگر به خسیس‌ترین بندگان.
گرت در دریای فضل است خیز		به تذکیر در پای درویش ریز
وگر نیستی سعی جاسوس گوش		خبر کی رسیدی به سلطان هوش
ملک را حسن تدبیر فقیه و تقریر جواب او موافق رای آمد. خلعت و نعمت بخشید و پایه منصب بلند گردانید.
اگر روزی به دانش در فزودی		ز نادان تنگ روزی تر نبودی
پسر گفت: ای پدر! هر آینه تا رنج نبری گنج برنداری و تا جان در خطر ننهی بر دشمن ظفر نیابی و تا دانه پریشان نکنی خرمن برنگیری.
خشکسالی در اسکندریه عنان طاقت درویش از دست رفته بود، درهای آسمان بر زمین بسته و فریاد اهل زمین به آسمان پیوسته.
چو مردانگی آید از رهزنان		چه مردان لشکر، چه خیل زنان
بر حالت من رحمت آورد و به ده دینار از قیدم خلاص کرد و با خود به حلب برد و دختری که داشت به نکاح من در آورد به کابین صد دینار.
زن از مرد موذی به بسیار به		سگ از مردم مردم‌آزار به

رازی که نهان خواهی، با کس در میان منه وگر چه دوست مخلص باشد که مر آن دوست را نیز دوستان مخلص باشد، همچنین مسلسل.
یار دیرینه مرا گو به زبان توبه مده		که مرا توبه به شمشیر نخواهد بودن
گفت: بر رای خداوند روی زمین پوشیده نماند که تربیت یکسان است و طباع مختلف.
کاش کآن روز که در پای تو شد خار اجل		دست گیتی بزدی تیغ هلاکم بر سر
که گر خاک شد سعدی، او را چه غم؟		که در زندگی خاک بوده‌ست هم
غافلی را شنیدم که خانه رعیت خراب کردی تا خزانه سلطان آباد کند بی خبر از قول حکیمان که گفته‌اند هر که خدای را عزّ و جلّ بیازارد تا دل خلقی به دست آرد خداوند تعالی همان خلق را بر او گمارد تا دمار از روزگارش بر آرد
خطیب اندر این لختی بیندیشید و گفت: این مبارک خواب است که دیدی که مرا بر عیب خود واقف گردانیدی. معلوم شد که آواز ناخوش دارم و خلق از بلند خواندن من در رنج. توبه کردم کز این پس خطبه نگویم مگر به آهستگی.
گرت بار دیگر ببینم به تیغ		چو دشمن ببرم سرت بی دریغ
همچنین در قاع بسیط مسافری گم شده بود و قوت و قوّتش به آخر آمده و درمی چند بر میان داشت. بسیاری بگردید و ره به جایی نبرد. پس به سختی هلاک شد. طایفه‌ای برسیدند و درمها دیدند پیش رویش نهاده و بر خاک نبشته:
امید بسته بر آمد ولی چه فایده زانک 		امید نیست که عمر گذشته باز آید

فرشته خوی شود آدمی به کم خوردن		وگر خورد چو بهایم بیوفتد چو جماد
شبی زیت فکرت همی سوختم		چراغ بلاغت می افروختم
شاه از بهر دفع ستمکاران است و شحنه برای خونخواران و قاضی مصلحت جوی طراران. هرگز دو خصم به حق راضی پیش قاضی نروند.
ردّ میراث سخت‌تر بودی		وارثان را ز مرگ خویشاوند
که همچون پدر خواهد این سفله مرد		که نعمت رها کرد و حسرت ببرد
حسد مرد را بر سر کینه داشت		یکی را به خون خوردنش بر گماشت
ببایدت عذر خطا خواستن		پس از شیخ صالح دعا خواستن
به خرده توان آتش افروختن		پس آنگه درخت کهن سوختن
فی الجمله پاس خاطر یاران را موافقت کردم و شبی به چند مجاهده به روز آوردم.
بعد از تأمل این معنی مصلحت چنان دیدم که در نشیمن عزلت نشینم و دامن صحبت فراهم چینم و دفتر از گفت‌های پریشان بشویم و من بعد پریشان نگویم.

