بر سلامت حالش شادمانی کرد و از هر دری سخن گفتند تا ملک به انجام سخن گفت: چنین که من این هر دو طایفه را دوست دارم در جهان کس ندارد یکی علما و دیگر زهاد را.
بسیج ِ سخن گفتن آنگاه کن		که دانی که در کار گیرد سخُن
سخن را سر است اى خردمند و بن		میاور سخن در میان سخن
سوم باب عشق است و مستی و شور		نه عشقی که بندند بر خود بزور
سخنهای دانای شیرین سخن		گرفت اندر آن هر دو شمشاد بن
سخن ماند از عاقلان یادگار		ز سعدی همین یک سخن یاد دار
تو که در بند خویشتن باشی		عشق باز دروغ زن باشی
اگر مرد عشقی کم خویش گیر		و گر نه ره عافیت پیش گیر
تقصیر و تقاعدی که در مواظبت خدمت بارگاه خداوندی می‌رود بنا بر آن است که طایفه‌ای از حکماء هندوستان در فضایل بزرجمهر سخن می‌گفتند، به آخر جز این عیبش ندانستند که در سخن گفتن بطیء است یعنی درنگ بسیار می‌کند و مستمع را بسی منتظر باید بودن تا تقریر سخنی کند. بزرجمهر بشنید و گفت: اندیشه کردن که چه گویم به از پشیمانی خوردن که چرا گفتم.
سخن آخر به دهان می‌گذرد موذی را 		سخنش تلخ نخواهی دهنش شیرین کن

امید بسته بر آمد ولی چه فایده زانک 		امید نیست که عمر گذشته باز آید
زرش داد و گوهر به شکر قدوم		بپرسیدش از گوهر و زاد و بوم
بخواست دخترکی خوبروی گوهر نام		چو درج گوهرش از چشم مردمان بنهفت
چون بود اصل گوهری قابل		تربیت را در او اثر باشد
همان به گر آبستن گوهری		که همچون صدف سر به خود در بری
چو نومید ماند از همه چیز و کس		امیدش به فضل خدا ماند و بس
اگر نفع کس در نهاد تو نیست		چنین گوهر و سنگ خارا یکی است
بدین امید به سر شد دریغ عمر عزیز 		که آنچه در دلم است از درم فراز آید
پدر گفتش اندر شب تیره رنگ		چه دانی که گوهر کدام است و سنگ؟
گر بی هنرم وگر هنرمند		لطف است امیدم از خداوند

اتابک محمد شه نیکبخت		خداوند تاج و خداوند تخت
خداوند از آن بنده خرسند نیست		که راضی به قسم خداوند نیست
بزرگان روشندل نیکبخت		به فرزانگی تاج بردند و تخت
خداوندان کام و نیکبختی		چرا سختی خورند از بیم سختی
چو باز آمد از عیش و شادی به جای		مرا دید و گفت ای خداوند رای
بر آورد مرد جهاندیده دست		چه گفت ای خداوند بالا و پست
گر امروز بودی خداوند جاه		نکردی خود از کبر در وی نگاه
یکی را به سر برنهد تاج بخت		یکی را به خاک اندر آرد ز تخت
پس ای مرد پوینده بر راه راست		تو را نیست منت، خداوند راست
زورت ار پیش می‌رود با ما 		با خداوند غیب دان نرود

مرا لفظ شیرین خواننده داد		تو را سمع و ادراک داننده داد
چنین دارم از پیر داننده یاد		که شوریده‌ای سر به صحرا نهاد
زبان کرد شخصی به غیبت دراز		بدو گفت داننده‌ای سرفراز
بد اندیش را لفظ شیرین مبین		که ممکن بود زهر در انگبین
همی گفت و گریان بر احوال طی		به سمع رسول آمد آواز وی
در این شهر باری به سمعم رسید		که بازارگانی غلامی خرید
نه ادراک در کنه ذاتش رسید		نه فکرت به غور صفاتش رسید
روانت داد و طبع و عقل و ادراک		جمال و نطق و رای و فکرت و هوش
در ارکان دولت نگه کرد شاه		کز این خوبتر لفظ و معنی مخواه
چو بسم الله آغاز کردند جمع		نیامد ز پیرش حدیثی به سمع

عسل دادت از نحل و من از هوا		رطب دادت از نخل و نخل از نوی
گفتند: فلان دشنام دادش.
تن کارکن می‌بلرزد ز تب		مبادا که نخلش نیارد رطب
ز گوش پنبه برون آر و داد خلق بده		وگر تو می‌ندهی داد روز دادی هست
به مردان راهت که راهی بده		وز این دشمنانم پناهی بده
ملک را گفت درویش استوار آمد. گفت: از من تمنا بکن. گفت: آن همی‌خواهم که دگرباره زحمت من ندهی. گفت: مرا پندی بده. گفت:
همه نخلبندان بخایند دست		ز حیرت که نخلی چنین کس نبست
زر بده مرد سپاهی را تا سر بنهد 		و گرش زر ندهی سر بنهد در عالم
پیش که بر آورم ز دستت فریاد 		هم پیش تو از دست تو گر خواهم داد
به گردن در آتش در افتاده‌ای		به باد هوی عمر بر داده‌ای

سر آنگه به بالین نهد هوشمند		که خوابش به قهر آورد در کمند
چون به بالینش فراز شدم این می‌گفت:
تواضع کند هوشمند گزین		نهد شاخ پر میوه سر بر زمین
فروتن بود هوشمند گزین		نهد شاخ پر میوه سر بر زمین
نه خوابش گرفتی شبان یک نفس		نه از دست فریاد او خواب کس
مرا همچو تو خواب خوش در سر است		ولیکن بیابان به پیش اندر است
اگر سر نهد بر خطت سروری		چو نیکش بداری، نهد دیگری
چه سود از دزدی آنگه توبه کردن		که نتوانی کمند انداخت بر کاخ
جوان از خواب مستی سر بر آورد و گفت:
همه شب در این فکر بود و نخفت		دگر روز با هوشمندان بگفت

هر آن سری که در سر داری با دوست در میان منه چه دانی که وقتی دشمن گردد و هر گزندی که توانی، به دشمن مرسان که باشد که وقتی دوست شود.
مرا با تو دانی سر دوستی است		تو را دشمنی با من از بهر چیست؟
بود دشمنش تازه و دوست ریش		کسی کش بود دشمن از دوست بیش
به نرمی ز دشمن توان کرد دوست		چو با دوست سختی کنی دشمن اوست
من اینک دم دوستی می‌زنم		گر او دوست دارد وگر دشمنم
کسی قول دشمن نیارد به دوست		جز آن کس که در دشمنی یار اوست
چو دشمن به دشمن بود مشتغل		تو با دوست بنشین به آرام دل
بر این گفتم آن دوست دشمن گرفت		چو آتش شد از خشم و در من گرفت
بباید چنین دشمنی دوست داشت		که می‌دانمش دوست بر من گماشت
نظر دوست نادر کند سوی تو		چو در روی دشمن بود روی تو

هارون الرشید را چون ملک دیار مصر مسلم شد گفت: به خلاف آن طاغی که به غرور ملک مصر دعوی خدایی کرد نبخشم این مملکت را مگر به خسیس‌ترین بندگان.
ور وزیر از خدا بترسیدی 		همچنان کز ملک، ملک بودی
این بگفت و طایفه ای از ندمای ملک با وی به شفاعت یار شدند تا ملک از سر خون او در گذشت و گفت: بخشیدم اگر چه مصلحت ندیدم.
خواهی که خدای بر تو بخشد 		با خلق خدای کن نکویی
بر سر ملک مباد آن ملک فرمانده		که خدا را نبود بندهٔ فرمانبردار
ز جرمم در این مملکت جاه نیست		ولیکن به ملکی دگر راه نیست
نگویم بزرگی و جاهم ببخش		فروماندگی و گناهم ببخش
که در مصر چون من عزیزی نبود		چو حاصل همین بود چیزی نبود
هر که بر خویشتن نبخشاید		گر نبخشد کسی بر او شاید
ندیمی زمین ملک بوسه داد		که ملک خداوند جاوید باد

روزگاری برآمد که اتفاق ملاقات نیوفتاد. بعد از آن دیدمش زن خواسته و فرزندان خاسته و بیخ نشاطش بریده و گل هوس پژمریده.
که من گر گلی بر وجودت زنم		به نزدیک مردان نه مردم، زنم
زن خوب خوش خوی آراسته		چه ماند به نادان نو خاسته؟
جوانمرد و صاحب خرد دیدمش		به مردانگی فوق خود دیدمش
چو زن راه بازار گیرد بزن		وگرنه تو در خانه بنشین چو زن
مکن بد به فرزند مردم نگاه		که فرزند خویشت برآید تباه
مگر روزگاری هوس راندمی		ز خود گرد محنت بیفشاندمی
به زاری به شمشیر زن گفت زن		مرا نیز با جمله گردن بزن
وگر زن کند گوید از دست دل		به گردن در افتاد چون خر به گل
تو دست از وی و روزگارش بدار		که خود زیر دستش کند روزگار

فرشته خوی شود آدمی به کم خوردن		وگر خورد چو بهایم بیوفتد چو جماد
به کم کردن از عادت خویش خورد		توان خویشتن را ملک خوی کرد
از دست تو مشت بر دهان خوردن		خوشتر که به دست خویش نان خوردن
پس از بردن و گرد کردن چو مور		بخور پیش از آن که‌ت خورد کرم گور
توانگر خود آن لقمه چون می‌خورد		چو بیند که درویش خون می‌خورد؟
نه هر بار خرما توان خورد و برد		لت انبان بد عاقبت خورد و مرد
ز فرخنده خویی نخوردی بگاه		مگر بینوایی در آید ز راه
هر آن کس که فرزند را غم نخورد		دگر کس غمش خورد و بدنام کرد
که مرهم نهادم نه در خورد ریش		که در خورد انعام و اکرام خویش
بخور ای نیک سیرت سره مرد		کان نگون بخت گرد کرد و نخورد

