شنید این سخن پیر فرخنده فال		سخندان بود مرد دیرینه سال
چو مردم سخن گفت باید به هوش		وگر نه شدن چون بهایم خموش
اگر چون زنان جست خواهی گریز		مرو آب مردان جنگی مریز
گر چه دانی که نشنوند بگوی		هر چه دانی ز نیکخواهی و پند
ای به ناموس کرده جامه سپید		بهر پندار خلق و نامه سیاه
سخن میان دو دشمن چنان گوی که گر دوست گردند شرم زده نشوی.
به بد گفتن خلق چون دم زدی		اگر راست گویی سخن هم بدی
چنین گفت پیری پسندیده هوش		خوش آید سخنهای پیران به گوش
شنیدم که می‌گفت و گردن به بند		نباشد حذر با قدر سودمند
گر راست سخن گویی و در بند بمانی		به زآن که دروغت دهد از بند رهایی

طلبکار خیر است امیدوار		خدایا امیدی که دارد برآر
بسی بر سر خلق پاینده دار		به توفیق طاعت دلش زنده دار
به محشر که حاضر شوند انجمن		خدایا تو با او مکن حشر من
جهانت به کام و فلک یار باد		جهان آفرینت نگهدار باد
دعا گوی این دولتم بنده‌وار		خدایا تو این سایه پاینده دار
چه کردی که درنده رام تو شد		نگین سعادت به نام تو شد؟
بهشت برین ملک و مأوای ماست		که بند غم امروز بر پای ماست
در این بود سر بر زمین فدا		که گفتند در گوش جانش ندا
اگر تنگدستی مرو پیش یار		وگر سیم داری بیا و بیار
مرا رقتی در دل آمد بر این		که پاک است و خرم بهشت برین

اتابک محمد شه نیکبخت		خداوند تاج و خداوند تخت
به قدرت، نگهدار بالا و شیب		خداوند دیوان روز حسیب
خدای خواست که بر عالمی ببخشاید		تو را به رحمت خود پادشاه عالم کرد
سعدی ره کعبه رضا گیر		ای مرد خدا در خدا گیر
یکی هاتف از غیبش آواز داد		که ای نیکبخت مبارک نهاد
این حکم و غرور و خشم تا چند		هست از تو بزرگتر خداوند
پس ای مرد پوینده بر راه راست		تو را نیست منت، خداوند راست
وگر بر سرآید خداوند زور		نه زیرش کند عاقبت خاک گور؟
بزرگان روشندل نیکبخت		به فرزانگی تاج بردند و تخت
چو بینی دعاگوی دولت هزار		خداوند را شکر نعمت گزار

مرا لفظ شیرین خواننده داد		تو را سمع و ادراک داننده داد
نکو سیرتش دید و روشن قیاس		سخن سنج و مقدار مردم شناس
که فعل فلان را بباید بیان		وز این فعل بد می‌برآید عیان
فهم سخن چون نکند مستمع		قوت طبع از متکلم مجوی
که سالوک این منزلم عن قریب		بد از نیک کمتر شناسد غریب
به پرویزن معرفت بیخته		به شهد ظرافت برآمیخته
گروهی برآنند از اهل سخن		که حاتم اصم بود، باور مکن
ز روی گمان بر من اینها که بست		من از خود یقین می‌شناسم که هست
فی الجمله زبان از مکالمهٔ او در کشیدن قوّت نداشتم و روی از محاورهٔ او گردانیدن مروّت ندانستم که یار موافق بود و ارادت صادق.
گرش دامن از چنگ شهوت رها		کنی، رفت تا سدرةالمنتهی

عسل دادت از نحل و من از هوا		رطب دادت از نخل و نخل از نوی
چنان آسمان بر زمین شد بخیل		که لب تر نکردند زرع و نخیل
با فرومایه روزگار مبر 		کز نی بوریا شکر نخوری
یکی صوفیان بین که می خورده‌اند		مرقع به سیکی گرو کرده‌اند
کریما به رزق تو پرورده‌ایم		به انعام و لطف تو خو کرده‌ایم
سماطی بیفکند و اسبی بکشت		به دامن شکر دادشان زر به مشت
سفر کردگان لاابالی زیند		که پروردهٔ ملک و دولت نیند
قضا نقش یوسف جمالی نکرد		که ماهی گورش چو یونس نخورد
قضا نقش یوسف جمالی نکرد		که ماهی گورش چو یونس نخورد
که هر گه که باز آید از خوی زشت		به عیشی رسد جاودان در بهشت

سر آنگه به بالین نهد هوشمند		که خوابش به قهر آورد در کمند
تواضع کند هوشمند گزین		نهد شاخ پر میوه سر بر زمین
باش تا دستش ببندد روزگار 		پس به کام دوستان مغزش بر آر
مروت نبینم رهایی ز بند		به تنها و یارانم اندر کمند
کنند ابره پاکیزه‌تر ز آستر		که آن در حجاب است و این در نظر
فروتن بود هوشمند گزین		نهد شاخ پر میوه سر بر زمین
گر او پیشدستی کند غم مدار		ور افراسیاب است مغزش بر آر
که گر باز کوبد در کارزار		بر آرند عام از دماغش دمار
کنون باید ای خفته بیدار بود		چو مرگ اندر آرد ز خوابت، چه سود؟
با گرسنگی قوت پرهیز نماند		افلاس عنان از کف تقوی بستاند

هر آن سری که در سر داری با دوست در میان منه چه دانی که وقتی دشمن گردد و هر گزندی که توانی، به دشمن مرسان که باشد که وقتی دوست شود.
بود دشمنش تازه و دوست ریش		کسی کش بود دشمن از دوست بیش
کسی قول دشمن نیارد به دوست		جز آن کس که در دشمنی یار اوست
به نرمی ز دشمن توان کرد دوست		چو با دوست سختی کنی دشمن اوست
کنون دشمنان گر برندم اسیر		نباشد کس از دوستانم نصیر
ز دشمن جفا بردی از بهر دوست		که تریاک اکبر بود زهر دوست
من اینک دم دوستی می‌زنم		گر او دوست دارد وگر دشمنم
چو دشمن به دشمن بود مشتغل		تو با دوست بنشین به آرام دل
نه دشمن برست از زبانش نه دوست		نه سلطان که این بوم و بر زآن اوست
ادیم زمین، سفرهٔ عام اوست		بر این خوان یغما چه دشمن چه دوست

هارون الرشید را چون ملک دیار مصر مسلم شد گفت: به خلاف آن طاغی که به غرور ملک مصر دعوی خدایی کرد نبخشم این مملکت را مگر به خسیس‌ترین بندگان.
قومی بر این نمط که شنیدی، و طایفه‌ای خوان نعمت نهاده و دست کرم گشاده، طالب نامند و معرفت و صاحب دنیا و آخرت، چون بندگان حضرت پادشاه عالم عادل مؤید مظفر منصور، مالک ازمّهٔ اَنام، حامی ثغور اسلام، وارث ملک سلیمان، اعدل ملوک زمان، مظفر الدنیا و الدین، اتابک ابی بکر سعد ادام الله ایامه و نصر اعلامه.
اسکندر رومی را پرسیدند: دیار مشرق و مغرب به چه گرفتی که ملوک پیشین را خزاین و عمر و ملک و لشکر بیش از این بوده است ایشان را چنین فتحی میسر نشده. گفتا: به عون خدای عزّوجل هر مملکتی را که گرفتم رعیتش نیازردم و نام پادشاهان جز به نکویی نبردم.
ملک روی از این سخن به هم آورد و مر او را زجر فرمود و گفت مرا خداوند تعالی مالک این مملکت گردانیده است تا بخورم و ببخشم نه پاسبان که نگاه دارم
نعمت بسیارش فرمود و اکرام کرد تا یکی از ندمای حضرت پادشاه که در آن سال از سفر دریا آمده بود گفت من او را عید اضحی در بصره دیدم! معلوم شد که حاجی نیست. دیگری گفتا پدرش نصرانی بود در ملطیه، پس او شریف چگونه صورت بندد؟!، و شعرش را به دیوان انوری در یافتند.
ملک را مضمون اشارت عابد معلوم گشت. فرمود تا وجه کفاف وی معین دارند و بار عیال از دل او بر خیزد.
ملک پرسید چه می‌گوید؟ یکی از وزرای نیک محضر گفت: ای خداوند همی‌ گوید: وَ الْکاظِمینَ الغَیْظَ وَ الْعافِینَ عَنِ النّاسِ. ملک را رحمت آمد و از سر خون او در گذشت. وزیر دیگر که ضدّ او بود گفت: ابنای جنس ما را نشاید در حضرت پادشاهان جز به راستی سخن گفتن. این ملک را دشنام داد و ناسزا گفت. ملک روی از این سخن در هم آورد و گفت: آن دروغ وی پسندیده تر آمد مرا زین راست که تو گفتی که روی آن در مصلحتی بود و بنای این بر خبثی. و خردمندان گفته‌اند: دروغی مصلحت آمیز به که راستی فتنه‌انگیز.
الا به حکم آن که سوابق انعام خداوندی ملازم روزگار بندگان است مصلحتی که بینند و اعلام نکنند، نوعی از خیانت باشد. طریق صواب آن است که با این پسر گرد طمع نگردی و فرش ولع درنوردی که منصب قضا پایگاهی منیع است تا به گناهی شنیع ملوث نگردانی و حریف این است که دیدی و حدیث این که شنیدی.
ملک دانشمند را مؤاخذت کرد و معاتبت فرمود که وعده خلاف کردی و وفا به جا نیاوردی.
در خبر است از خواجهٔ عالم صلی الله علیه و سلم که گفت: بزرگترین حسرتی روز قیامت آن بود که یکی بندهٔ صالح را به بهشت برند و خواجهٔ فاسق را به دوزخ.

روزگاری برآمد که اتفاق ملاقات نیوفتاد. بعد از آن دیدمش زن خواسته و فرزندان خاسته و بیخ نشاطش بریده و گل هوس پژمریده.
شب را به بوستان با یکی از دوستان اتفاق مبیت افتاد، موضعی خوش و خرّم و درختان در هم. گفتی که خردهٔ مینا بر خاکش ریخته و عقد ثریا از تارکش آویخته.
جوانی چست لطیف خندان شیرین زبان در حلقه عشرت ما بود که در دلش از هیچ نوعی غم نیامدی و لب از خنده فرا هم.
وقتی به جهل جوانی بانگ بر مادر زدم، دل آزرده به کنجی نشست و گریان همی‌گفت: مگر خردی فراموش کردی که درشتی میکنی؟
غم موجود و پریشانی معدوم ندارم		نفسی می‌زنم آسوده و عمری می‌گذارم »
خوشا وقت شوریدگان غمش		اگر زخم بینند و گر مرهمش
جوانی فرا رفت کای پیرمرد		چه در کنج حسرت نشینی به درد؟
دو کس را حسرت از دل نرود و پای تغابن از گل بر نیاید: تاجر کشتی شکسته و وارث با قلندران نشسته.
پیرمردی حکایت کند که دختری خواسته بود و حجره به گل آراسته و به خلوت با او نشسته و دیده و دل در او بسته و شبهای دراز نخفتی و بذله‌ها و لطیفه‌ها گفتی باشد که مؤانست پذیرد و وحشت نگیرد.
مگو تندرست است رنجوردار		که می‌پیچد از غصه رنجوروار

فرشته خوی شود آدمی به کم خوردن		وگر خورد چو بهایم بیوفتد چو جماد
نه آیین عقل است و رای و خرد		که دانا فریب مشعبد خورد
تا یکی از دوستان که در کجاوه انیس من بود و در حجره جلیس، به رسم قدیم از در در آمد. چندان که نشاط ملاعبت کرد و بساط مداعبت گسترد جوابش نگفتم و سر از زانوی تعبّد بر نگرفتم. رنجیده نگه کرد و گفت:
نه زهره که فرمان نگیرد به گوش		نه یارا که مست اندر آرد به دوش
دور جوانی بشد از دست من		آه و دریغ آن زمن دل فروز
شنیده‌ای که سکندر برفت تا ظلمات		به چند محنت و خورد آن که خورد آب حیات
عجب آن که غراب از مجاورت طوطی هم به جان آمده بود و ملول شده. لاحول کنان از گردش گیتی همی‌نالید و دستهای تغابن بر یکدگر همی مالید که: این چه بخت نگون است و طالع دون و ایام بوقلمون. لایق قدر من آنستی که با زاغی به دیوار باغی بر خرامان همی رفتمی.
ببخشود بر حال مسکین مرد		فرو خورد خشم سخنهای سرد
شبی مست شد و آتشی برفروخت		نگون بخت کالیوه، خرمن بسوخت
گروهی مردمان را دید هر یک به قراضه‌ای در معبر نشسته و رخت سفر بسته. جوان را دست عطا بسته بود، زبان ثنا برگشود. چندان که زاری کرد یاری نکردند. ملاح بی مروت به خنده برگردید و گفت:

